NO ./path_to_the_north_texture
EA ./path_to_the_east_texture
WE ./path_to_the_west_texture
SO ./path_to_the_south_texture

F 220,100,0
C 225,30,0

1111111111111111111
1000000000000000001
1001111111111100001
100100000E0001000011111111111
10000001110001000000011110001
10000000010001000000000000001
10010011010001111100000000001
10000001010000000100010000001
11110001011111110100010000001
10000000000000000000011111111
10011111111111110100000000001
10010000000000000001111111001
10010000000000000000000000011
1001000000000000000000000001
1111111111111111111111111111
